27,27,2,4,1,4,
9,9,9,9,9,9,9,9,9,9,9,9,9,9,9,9,9,9,9,9,9,9,9,9,9,9,9
9,1,1,1,1,1,1,1,1,1,1,1,1,9,1,1,1,1,1,1,1,1,1,1,1,1,9
9,1,9,9,9,9,1,9,9,9,9,9,1,9,1,9,9,9,9,9,1,9,9,9,9,1,9
9,1,9,9,9,9,1,9,9,9,9,9,1,9,1,9,9,9,9,9,1,9,9,9,9,1,9
9,1,9,9,9,9,1,9,9,9,9,9,1,9,1,9,9,9,9,9,1,9,9,9,9,1,9
9,1,1,1,1,1,1,1,1,1,1,1,1,1,1,1,1,1,1,1,1,1,1,1,1,1,9
9,1,9,9,9,9,1,9,1,9,9,9,9,9,9,9,9,9,1,9,1,9,9,9,9,1,9
9,1,9,9,9,9,1,9,1,9,9,9,9,9,9,9,9,9,1,9,1,9,9,9,9,1,9
9,1,1,1,1,1,1,9,1,1,1,1,1,9,1,1,1,1,1,9,1,1,1,1,1,1,9
9,9,9,9,9,9,1,9,9,9,9,9,1,9,1,9,9,9,9,9,1,9,9,9,9,9,9
9,0,0,0,0,9,1,9,0,0,0,0,0,0,0,0,0,0,0,9,1,9,0,0,0,0,9
9,0,0,0,0,9,1,9,0,9,0,9,9,9,9,9,0,9,0,9,1,9,0,0,0,0,9
9,0,0,0,0,9,1,9,0,9,0,0,0,0,0,0,0,9,0,9,1,9,0,0,0,0,9
9,0,0,0,0,9,1,1,0,9,0,0,0,0,0,0,0,9,0,1,1,9,0,0,0,0,9
9,0,0,0,0,9,1,9,0,9,0,9,9,9,9,9,0,9,0,9,1,9,0,0,0,0,9
9,0,0,0,0,9,1,9,0,0,0,0,0,0,0,0,0,0,0,9,1,9,0,0,0,0,9
9,0,0,0,0,9,1,9,1,9,9,9,9,9,9,9,9,9,1,9,1,9,0,0,0,0,9
9,9,9,9,9,9,1,9,1,9,9,9,9,9,9,9,9,9,1,9,1,9,9,9,9,9,9
9,1,1,1,1,1,1,1,1,1,1,1,1,9,1,1,1,1,1,1,1,1,1,1,1,1,9
9,1,9,9,9,9,1,9,9,9,9,9,1,9,1,9,9,9,9,9,1,9,9,9,9,1,9
9,1,1,1,1,9,1,1,1,1,1,1,1,1,1,1,1,1,1,1,1,9,1,1,1,1,9
9,9,9,9,1,9,1,9,1,9,9,9,9,9,9,9,9,9,1,9,1,9,1,9,9,9,9
9,9,9,9,1,9,1,9,1,9,9,9,9,9,9,9,9,9,1,9,1,9,1,9,9,9,9
9,1,1,1,1,1,1,9,1,1,1,1,1,9,1,1,1,1,1,9,1,1,1,1,1,1,9
9,1,9,9,9,9,9,9,9,9,9,9,1,9,1,9,9,9,9,9,9,9,9,9,9,1,9
9,1,1,1,1,1,1,1,1,1,1,1,1,1,1,1,1,1,1,1,1,1,1,1,1,1,9
9,9,9,9,9,9,9,9,9,9,9,9,9,9,9,9,9,9,9,9,9,9,9,9,9,9,9